$$万里音・$勇美・千恵	$$万里音・$勇美・千惠
万里音・$勇美・千恵	万里音・$勇美・千惠
$$万里音・$勇美	$$万里音・$勇美
購買の$おばさん	購買の$おばさん
万里音・$崎人	万里音・$崎人
万里音・$勇美	万里音・$勇美
崎人・$万里音	崎人・$万里音
サ・キ・ちゃん	サ・キ・ちゃん
万里音姉ちゃん	万里音姐
万里音ちゃん	万里音酱	girl
龍太朗ちゃん	龙太朗酱	boy
藤岡屋ちゃん	藤冈屋酱	boy
比留間ちゃん	比留间酱	boy
新聞部$一同	新聞部$一同
崎人ちゃん	崎人酱	boy
安城ちゃん	安城酱	boy
万里音くん	万里音君	girl
安城ちゃん	安城酱	girl
万里音さん	万里音小姐	girl
万里音先生	万里音先生	girl
万里音先輩	万里音前辈	girl
千恵ちゃん	千惠酱	girl
日下ちゃん	日下酱	girl
勇美ちゃん	勇美酱	girl
クリちゃん	クリちゃん
サキちゃん	小崎
龍太朗くん	龙太朗君	boy
藤岡屋くん	藤冈屋君	boy
龍太朗さん	龙太朗桑	boy
藤岡屋さん	藤冈屋桑	boy
龍太朗先生	龙太朗先生	boy
藤岡屋先生	藤冈屋先生	boy
龍太朗先輩	龙太朗前辈	boy
藤岡屋先輩	藤冈屋前辈	boy
比留間くん	比留间君	boy
健吾ちゃん	健吾酱	boy
比留間さん	比留间桑	boy
比留間先生	比留间先生	boy
比留間先輩	比留间前辈	boy
風紀委員Ｂ	風紀委員Ｂ
風紀委員Ｃ	風紀委員Ｃ
風紀委員Ａ	風紀委員Ａ
風紀委員Ｄ	風紀委員Ｄ
男子生徒Ａ	男子生徒Ａ
男子生徒Ｂ	男子生徒Ｂ
男子生徒Ｃ	男子生徒Ｃ
男子生徒Ｄ	男子生徒Ｄ
女子生徒Ａ	女子生徒Ａ
新聞部顧問	新闻部顾问
家庭科教師	家庭科教师
女子生徒Ｆ	女子生徒Ｆ
女子生徒１	女子生徒１
女子生徒２	女子生徒２
男子生徒１	男子生徒１
女子生徒３	女子生徒３
女子生徒Ｂ	女子生徒Ｂ
女子生徒Ｃ	女子生徒Ｃ
女子生徒Ｄ	女子生徒Ｄ
女子生徒Ｅ	女子生徒Ｅ
カップル女	カップル女
カップル男	カップル男
女子生徒Ｇ	女子生徒Ｇ
男子生徒２	男子生徒２
男子生徒３	男子生徒３
女子生徒達	女子生徒達
$$万里音	$$万里音
日下_さん	日下_さん
姉ちゃん	姐姐
崎人くん	崎人君	boy
安城くん	安城君	boy
崎人さん	崎人桑	boy
安城さん	安城桑	boy
崎人先生	崎人先生	boy
安城先生	安城先生	boy
崎人先輩	崎人前辈	boy
安城先輩	安城前辈	boy
安城くん	安城君	girl
安城さん	安城小姐	girl
安城先生	安城先生	girl
安城先輩	安城前辈	girl
千恵くん	千惠君	girl
日下くん	日下君	girl
千恵さん	千惠小姐	girl
日下さん	日下小姐	girl
千恵先生	千惠先生	girl
日下先生	日下先生	girl
千恵先輩	千惠前辈	girl
日下先輩	日下前辈	girl
勇美くん	勇美君	girl
勇美さん	勇美小姐	girl
勇美先生	勇美先生	girl
勇美先輩	勇美前辈	girl
健吾くん	健吾君	boy
健吾さん	健吾桑	boy
健吾先生	健吾先生	boy
健吾先輩	健吾前辈	boy
担任先生	班主任
副委員長	副委员长
男生徒Ａ	男生徒Ａ
男生徒Ｂ	男生徒Ｂ
男生徒Ｃ	男生徒Ｃ
男生徒Ｄ	男生徒Ｄ
女生徒Ａ	女生徒Ａ
女生徒Ｄ	女生徒Ｄ
男生徒Ｅ	男生徒Ｅ
女生徒Ｆ	女生徒Ｆ
女生徒Ｂ	女生徒Ｂ
女生徒Ｃ	女生徒Ｃ
男性教師	男教师
園芸部員	园艺部员
女生徒１	女生徒１
女生徒２	女生徒２
女子生徒	女学生
男先生１	男先生１
男先生２	男先生２
女先生１	女先生１
保健先生	保健老师
弟くん	弟君
万里音	万里音	安城万里音’s firstname,girl
藤岡屋	藤冈屋	藤岡屋龍太朗’s lastname,boy
龍太朗	龙太朗	藤岡屋龍太朗’s firstname,boy
比留間	比留间	比留間健吾’s lastname,boy
生徒Ａ	生徒Ａ
生徒Ｂ	生徒Ｂ
生徒Ｃ	生徒Ｃ
生徒Ｄ	生徒Ｄ
？千恵	？千惠
警備員	警卫员
用務員	勤杂工
男生徒	男学生
男店員	男店员
女店員	女店员
女客１	女客１
男客１	男客１
女客２	女客２
男客２	男客２
男先生	男老师
女先生	女老师
女教師	女教师
清掃員	清洁工
安城	安城	安城崎人’s lastname,boy
崎人	崎人	安城崎人’s firstname,boy
安城	安城	安城万里音’s lastname,girl
日下	日下	日下千恵’s lastname,girl
千恵	千惠	日下千恵’s firstname,girl
日下	日下	日下勇美’s lastname,girl
勇美	勇美	日下勇美’s firstname,girl
健吾	健吾	比留間健吾’s firstname,boy
司会	司会
先生	老师
店員	店员
客１	客１
客２	客２
子供	子供
母親	母亲
級長	班长
＠	＠
＃	＃
母	母